year,country,inflow,outflow,latitude,longitude,net_migrants
1990,Afghanistan,50671,3581557,33.93911,67.709953,-3530886
1990,Mongolia,6043,2718,46.862496,103.846656,3325
1990,Monaco,11565,4213,43.750298,7.412841,7352
1990,British Virgin Islands,7516,429,18.420695,-64.639968,7087
1990,Mexico,693754,4383467,23.634501,-102.552784,-3689713
1990,Mayotte,12733,1800,-12.8275,45.166244,10933
1990,Mauritius,3246,107998,-20.348404,57.552152,-104752
1990,Bulgaria,19077,603562,42.733883,25.48583,-584485
1990,Mauritania,110227,133163,21.00789,-10.940835,-22936
1990,Martinique,37033,11003,14.641528,-61.024174,26030
1990,Marshall Islands,1022,1613,7.131474,171.184478,-591
1990,Burkina Faso,326879,1018342,12.238333,-1.561593,-691463
1990,Malta,14979,110152,35.937496,14.375416,-95173
1990,Mali,142919,642857,17.570692,-3.996166,-499938
1990,Maldives,8435,2057,3.202778,73.22068,6378
1990,Burundi,273491,84615,-3.373056,29.918886,188876
1990,Malaysia,609304,511291,4.210484,101.975766,98013
1990,Malawi,1096822,114130,-13.254308,34.301525,982692
1990,Madagascar,17503,58481,-18.766947,46.869107,-40978
1990,Cambodia,32682,331826,12.565679,104.990963,-299144
1990,Luxembourg,113439,27725,49.815273,6.129583,85714
1990,Lithuania,335946,258023,55.169438,23.881275,77923
1990,Liechtenstein,10877,3428,47.166,9.555373,7449
1990,Cameroon,212475,111107,7.369722,12.354722,101368
1990,Libya,457075,75547,26.3351,17.228331,381528
1990,Liberia,74599,516716,6.428055,-9.429499,-442117
1990,Lesotho,4469,191907,-29.609988,28.233608,-187438
1990,Canada,4327805,984542,56.130366,-106.346771,3343263
1990,Montserrat,1652,6539,16.742498,-62.187366,-4887
1990,Brazil,770323,484101,-14.235004,-51.92528,286222
1990,Morocco,43973,1584880,31.791702,-7.09262,-1540907
1990,Mozambique,58963,2073203,-18.665695,35.529562,-2014240
1990,Poland,1073550,1493977,51.919438,19.145136,-420427
1990,Philippines,128466,1977624,12.879721,121.774017,-1849158
1990,Belgium,876683,363573,50.503887,4.469936,513110
1990,Peru,63987,275930,-9.189967,-75.015152,-211943
1990,Paraguay,189434,296281,-23.442503,-58.443832,-106847
1990,Papua New Guinea,31057,3015,-6.314993,143.95555,28042
1990,Belize,29314,35104,17.189877,-88.49765,-5790
1990,Panama,62485,133058,8.537981,-80.782127,-70573
1990,Palau,2695,5522,7.51498,134.58252,-2827
1990,Pakistan,6203799,3317683,30.375321,69.345116,2886116
1990,Benin,63876,228961,9.30769,2.315834,-165085
1990,Oman,299352,3362,21.512583,55.923255,295990
1990,Norway,186730,137054,60.472024,8.468946,49676
1990,Lebanon,520116,493739,33.854721,35.862285,26377
1990,Northern Mariana Islands,25498,4383,17.33083,145.38469,21115
1990,Niue,404,5860,-19.054445,-169.867233,-5456
1990,Nigeria,299556,447098,9.081999,8.675277,-147542
1990,Niger,105305,132697,17.607789,8.081666,-27392
1990,Bhutan,21982,28366,27.514162,90.433601,-6384
1990,Nicaragua,40112,439370,12.865416,-85.207229,-399258
1990,New Zealand,499649,386204,-40.900557,174.885971,113445
1990,New Caledonia,35367,3308,-20.904305,165.618042,32059
1990,Bosnia and Herzegovina,54542,857782,43.915886,17.679076,-803240
1990,Netherlands,1180236,719956,52.132633,5.291266,460280
1990,Dominica,2055,37121,15.414999,-61.370976,-35066
1990,Nauru,2598,2332,-0.522778,166.931503,266
1990,Botswana,25829,25763,-22.328474,24.684866,66
1990,Namibia,117404,15579,-22.95764,18.49041,101825
1990,Bermuda,15030,71702,32.321384,-64.75737,-56672
1990,Portugal,431537,1798516,39.399872,-8.224454,-1366979
1990,Latvia,646007,119279,56.879635,24.603189,526728
1990,Cayman Islands,9314,373,19.513469,-80.566956,8941
1990,Grenada,2793,42345,12.262776,-61.604171,-39552
1990,Greenland,9354,9373,71.706936,-42.604303,-19
1990,Greece,618139,1037633,39.074208,21.824312,-419494
1990,Croatia,371626,423618,45.1,15.2,-51992
1990,Gibraltar,7438,11994,36.137741,-5.345374,-4556
1990,Ghana,153715,372922,7.946527,-1.023194,-219207
1990,Germany,5601544,3120888,51.165691,10.451526,2480656
1990,Cuba,29587,820216,21.521757,-77.781167,-790629
1990,Georgia,289184,259903,42.315407,43.356892,29281
1990,Gambia,114683,36140,13.443182,-15.310139,78543
1990,Gabon,124621,14212,-0.803689,11.609444,110409
1990,Cyprus,43432,173849,35.126413,33.429859,-130417
1990,French Polynesia,22416,3131,-17.679742,-149.406843,19285
1990,French Guiana,60358,2820,3.933889,-53.125782,57538
1990,France,5897267,1177678,46.227638,2.213749,4719589
1990,CÃ´te d'Ivoire,1794958,370737,7.539989,-5.54708,1424221
1990,Finland,61133,248732,61.92411,25.748151,-187599
1990,Fiji,11655,90639,-16.578193,179.414413,-78984
1990,Ethiopia,1125957,1687027,9.145,40.489673,-561070
1990,Denmark,235189,196395,56.26392,9.501785,38794
1990,Estonia,381355,51426,58.595272,25.013607,329929
1990,Eritrea,10766,170591,15.179384,39.782334,-159825
1990,Equatorial Guinea,2214,34152,1.650801,10.267895,-31938
1990,Djibouti,114910,5280,11.825138,42.590275,109630
1990,El Salvador,47116,1240800,13.794185,-88.89653,-1193684
1990,Egypt,164324,1299190,26.820553,30.802498,-1134866
1990,Ecuador,78436,188486,-1.831239,-78.183406,-110050
1990,Costa Rica,209300,67923,9.748917,-83.753428,141377
1990,Guadeloupe,61948,5767,16.995971,-62.067641,56181
1990,Guam,67120,2590,13.444304,144.793731,64530
1990,Guatemala,264169,342896,15.783471,-90.230759,-78727
1990,Kuwait,1048104,64453,29.31166,47.481766,983651
1990,Kiribati,1691,5330,-3.370417,-168.734039,-3639
1990,Kenya,196730,208097,-0.023559,37.906193,-11367
1990,Central African Republic,57307,35492,6.611111,20.939444,21815
1990,Kazakhstan,3619200,601644,48.019573,66.923684,3017556
1990,Jordan,1144334,256358,30.585164,36.238414,887976
1990,Japan,1065694,594987,36.204824,138.252924,470707
1990,Chad,69111,333508,15.454166,18.732207,-264397
1990,Jamaica,18126,587884,18.109581,-77.297508,-569758
1990,Italy,1428221,3348301,41.87194,12.56738,-1920080
1990,Israel,1489650,176655,31.046051,34.851612,1312995
1990,Chile,107501,462262,-35.675147,-71.542969,-354761
1990,Isle of Man,33140,10735,54.236107,-4.548056,22405
1990,Kyrgyzstan,608720,88953,41.20438,74.766098,519767
1990,Ireland,227961,915226,53.41291,-8.24389,-687265
1990,China,298400,2210076,35.86166,104.195397,-1911676
1990,Indonesia,374951,1540590,-0.789275,113.921327,-1165639
1990,India,7362652,6647471,20.593684,78.96288,715181
1990,Iceland,9584,17307,64.963051,-19.020835,-7723
1990,Colombia,103448,451756,4.570868,-74.297333,-348308
1990,Hungary,336699,365438,47.162494,19.503304,-28739
1990,Honduras,270279,155883,15.199999,-86.241905,114396
1990,Haiti,17725,521033,18.971187,-72.285215,-503308
1990,Comoros,12560,39716,-11.875001,43.872219,-27156
1990,Guyana,3674,228668,4.860416,-58.93018,-224994
1990,Guinea-Bissau,14726,54437,11.803749,-15.180413,-39711
1990,Guinea,399986,352091,9.945587,-9.696645,47895
1990,Cook Islands,2511,17488,-21.236736,-159.777671,-14977
1990,Iraq,63698,347326,33.223191,43.679291,-283628
1990,Belarus,1248782,945689,53.709807,27.953389,303093
1990,Nepal,411030,737590,28.394857,84.124008,-326560
1990,Dominican Republic,289949,437969,18.735693,-70.162651,-148020
1990,Somalia,460000,846170,5.152149,46.199616,-386170
1990,Australia,3948318,295844,-25.274398,133.775136,3652474
1990,Turks and Caicos Islands,4481,2311,21.694025,-71.797928,2170
1990,Solomon Islands,3925,2251,-9.64571,160.156194,1674
1990,Tuvalu,239,3013,-7.109535,177.64933,-2774
1990,Slovenia,174420,91101,46.151241,14.995463,83319
1990,Andorra,38137,3786,42.546245,1.601554,34351
1990,Slovakia,41183,62130,48.669026,19.699024,-20947
1990,Uganda,536580,273260,1.373333,32.290275,263320
1990,South Africa,1057863,326886,-30.559482,22.937506,730977
1990,Austria,793239,499041,47.516231,14.550072,294198
1990,Ukraine,6481438,1993336,48.379433,31.16558,4488102
1990,Sierra Leone,221192,60932,8.460555,-11.779889,160260
1990,United Arab Emirates,1287556,68620,23.424076,53.847818,1218936
1990,Seychelles,2947,29162,-4.679574,55.491977,-26215
1990,Azerbaijan,357078,692656,40.143105,47.576927,-335578
1990,Serbia,99189,688943,44.016521,21.005859,-589754
1990,American Samoa,20486,1082,-14.270972,-170.132217,19404
1990,United Kingdom,3641645,3721069,55.378051,-3.435973,-79424
1990,Senegal,234420,365521,14.497401,-14.452362,-131101
1990,Singapore,445694,147704,1.352083,103.819836,297990
1990,Saudi Arabia,4830679,84552,23.885942,45.079162,4746127
1990,Turkmenistan,304375,93840,38.969719,59.556278,210535
1990,Angola,27759,327648,-11.202692,17.873887,-299889
1990,Timor-Leste,7892,11250,-8.874217,125.727539,-3358
1990,Togo,74051,192617,8.619543,0.824782,-118566
1990,Thailand,528671,283771,15.870032,100.992541,244900
1990,Tokelau,245,1684,-8.967363,-171.855881,-1439
1990,Tajikistan,428236,111509,38.861034,71.276093,316727
1990,Argentina,1565392,398212,-38.416097,-63.616672,1167180
1990,Tonga,820,32664,-21.178986,-175.198242,-31844
1990,Switzerland,1162183,321047,46.818188,8.227512,841136
1990,Sweden,720175,206188,60.128161,18.643501,513987
1990,Spain,817571,1337398,40.463667,-3.74922,-519827
1990,Anguilla,1902,462,18.220554,-63.068615,1440
1990,Swaziland,67820,35133,-26.522503,31.465866,32687
1990,Trinidad and Tobago,46645,191409,10.691803,-61.222503,-144764
1990,Armenia,564662,363639,40.069099,45.038189,201023
1990,Suriname,10581,177545,3.919305,-56.027783,-166964
1990,Tunisia,32025,452415,33.886917,9.537499,-420390
1990,Sudan,1369612,570564,12.862807,30.217636,799048
1990,Sri Lanka,39935,883382,7.873054,80.771797,-843447
1990,Turkey,979704,2505634,38.963745,35.243322,-1525930
1990,Aruba,11099,5374,12.52111,-69.968338,5725
1990,Puerto Rico,312915,1197010,18.220833,-66.590149,-884095
1990,United States of America,20134790,1703690,37.09024,-95.712891,18431100
1990,Antigua and Barbuda,11204,17017,17.060816,-61.796428,-5813
1990,Western Sahara,2580,168124,24.215527,-12.885834,-165544
1990,Bangladesh,741548,5447404,23.684994,90.356331,-4705856
1990,Saint Helena,345,853,-24.143474,-10.030696,-508
1990,Saint Kitts and Nevis,1521,12801,17.357822,-62.782998,-11280
1990,Bahamas,25319,25119,25.03428,-77.39628,200
1990,Yemen,90251,452942,15.552727,48.516388,-362691
1990,Saint Lucia,3473,19407,13.909444,-60.978893,-15934
1990,RÃ©union,44104,3087,-21.115141,55.536384,41017
1990,Vanuatu,1565,4905,-15.376706,166.959158,-3340
1990,Saint Pierre and Miquelon,945,485,46.941936,-56.27111,460
1990,Rwanda,139650,458956,-1.940278,29.873888,-319306
1990,Zambia,269896,64663,-13.133897,27.849332,205233
1990,Albania,58703,133396,41.153332,20.168331,-74693
1990,Bahrain,170701,4410,25.930414,50.637772,166291
1990,Barbados,18452,84235,13.193887,-59.543198,-65783
1990,Saint Vincent and the Grenadines,3718,36465,12.984305,-61.287228,-32747
1990,Uzbekistan,1577433,534964,41.377491,64.585262,1042469
1990,Uruguay,91866,230292,-32.522779,-55.765835,-138426
1990,Algeria,258623,904559,28.033886,1.659626,-645936
1990,Qatar,305265,2206,25.354826,51.183884,303059
1990,Samoa,3124,74861,-13.759029,-172.104629,-71737
1990,Romania,126763,800204,45.943161,24.96676,-673441
1990,Zimbabwe,598946,175924,-19.015438,29.154857,423022
1990,San Marino,3203,1383,43.94236,12.457777,1820
1995,Dominican Republic,322076,648240,18.735693,-70.162651,-326164
1995,Haiti,20863,657713,18.971187,-72.285215,-636850
1995,Togo,90722,305507,8.619543,0.824782,-214785
1995,Zimbabwe,393451,251700,-19.015438,29.154857,141751
1995,Tunisia,31851,466215,33.886917,9.537499,-434364
1995,Eritrea,11030,325246,15.179384,39.782334,-314216
1995,Honduras,149299,246240,15.199999,-86.241905,-96941
1995,Ireland,226892,861772,53.41291,-8.24389,-634880
1995,Equatorial Guinea,2934,40737,1.650801,10.267895,-37803
1995,Zambia,232452,125688,-13.133897,27.849332,106764
1995,Hungary,313738,381492,47.162494,19.503304,-67754
1995,Egypt,157862,1469915,26.820553,30.802498,-1312053
1995,Ecuador,100213,297902,-1.831239,-78.183406,-197689
1995,Yemen,104345,483911,15.552727,48.516388,-379566
1995,Iraq,175951,490586,33.223191,43.679291,-314635
1995,El Salvador,39351,932073,13.794185,-88.89653,-892722
1995,Iceland,12738,21214,64.963051,-19.020835,-8476
1995,Tokelau,243,1810,-8.967363,-171.855881,-1567
1995,Indonesia,318970,1835338,-0.789275,113.921327,-1516368
1995,India,6824479,7163331,20.593684,78.96288,-338852
1995,Tonga,928,38340,-21.178986,-175.198242,-37412
1995,Trinidad and Tobago,42344,245740,10.691803,-61.222503,-203396
1995,Western Sahara,2865,167026,24.215527,-12.885834,-164161
1995,Gabon,148958,15114,-0.803689,11.609444,133844
1995,Turkey,1071547,2651471,38.963745,35.243322,-1579924
1995,Gambia,146646,38243,13.443182,-15.310139,108403
1995,United Kingdom,4132002,3639032,55.378051,-3.435973,492970
1995,United States of America,26593925,1791119,37.09024,-95.712891,24802806
1995,French Polynesia,24611,3726,-17.679742,-149.406843,20885
1995,Georgia,149590,298571,42.315407,43.356892,-148981
1995,Germany,7130259,3117452,51.165691,10.451526,4012807
1995,United Arab Emirates,1781444,87307,23.424076,53.847818,1694137
1995,Uruguay,86635,227478,-32.522779,-55.765835,-140843
1995,Ghana,241780,428663,7.946527,-1.023194,-186883
1995,French Guiana,66516,3197,3.933889,-53.125782,63319
1995,Ukraine,5774245,1942367,48.379433,31.16558,3831878
1995,Isle of Man,35239,9003,54.236107,-4.548056,26236
1995,France,6087993,1311518,46.227638,2.213749,4776475
1995,Greece,857850,1013337,39.074208,21.824312,-155487
1995,Uganda,613212,433897,1.373333,32.290275,179315
1995,Greenland,7235,11275,71.706936,-42.604303,-4040
1995,Finland,97820,286676,61.92411,25.748151,-188856
1995,Estonia,315177,63648,58.595272,25.013607,251529
1995,Guinea-Bissau,26883,65915,11.803749,-15.180413,-39032
1995,Guinea,769222,364983,9.945587,-9.696645,404239
1995,Turkmenistan,270049,69994,38.969719,59.556278,200055
1995,Guatemala,156124,456734,15.783471,-90.230759,-300610
1995,Ethiopia,765390,820057,9.145,40.489673,-54667
1995,Guyana,5631,289682,4.860416,-58.93018,-284051
1995,Vanuatu,1451,5629,-15.376706,166.959158,-4178
1995,Guam,69255,3061,13.444304,144.793731,66194
1995,Fiji,11396,107002,-16.578193,179.414413,-95606
1995,Guadeloupe,70073,6753,16.995971,-62.067641,63320
1995,Tuvalu,197,3337,-7.109535,177.64933,-3140
1995,Grenada,3570,53241,12.262776,-61.604171,-49671
1995,Uzbekistan,1433906,622866,41.377491,64.585262,811040
1995,Turks and Caicos Islands,5901,1536,21.694025,-71.797928,4365
1995,Gibraltar,7115,10134,36.137741,-5.345374,-3019
1995,Puerto Rico,328497,1403017,18.220833,-66.590149,-1074520
1995,Timor-Leste,8570,79035,-8.874217,125.727539,-70465
1995,Niger,136035,165686,17.607789,8.081666,-29651
1995,Nicaragua,25561,436002,12.865416,-85.207229,-410441
1995,Saint Vincent and the Grenadines,3874,45073,12.984305,-61.287228,-41199
1995,New Zealand,555116,414372,-40.900557,174.885971,140744
1995,New Caledonia,40990,3628,-20.904305,165.618042,37362
1995,Samoa,4410,81957,-13.759029,-172.104629,-77547
1995,Netherlands,1343094,728566,52.132633,5.291266,614528
1995,San Marino,3554,2420,43.94236,12.457777,1134
1995,Saint Pierre and Miquelon,1147,479,46.941936,-56.27111,668
1995,Nepal,651911,843144,28.394857,84.124008,-191233
1995,Saudi Arabia,4950773,108775,23.885942,45.079162,4841998
1995,Namibia,112236,27610,-22.95764,18.49041,84626
1995,Mozambique,91089,750624,-18.665695,35.529562,-659535
1995,Senegal,250016,351791,14.497401,-14.452362,-101775
1995,Morocco,40348,1734714,31.791702,-7.09262,-1694366
1995,Serbia,629705,902114,44.016521,21.005859,-272409
1995,Montserrat,1325,10864,16.742498,-62.187366,-9539
1995,Mongolia,6653,3806,46.862496,103.846656,2847
1995,Nauru,2400,2496,-0.522778,166.931503,-96
1995,Monaco,11581,4499,43.750298,7.412841,7082
1995,Nigeria,361537,519274,9.081999,8.675277,-157737
1995,Saint Lucia,4652,27675,13.909444,-60.978893,-23023
1995,Portugal,528127,1857395,39.399872,-8.224454,-1329268
1995,Poland,918272,1754362,51.919438,19.145136,-836090
1995,Qatar,353830,3562,25.354826,51.183884,350268
1995,Philippines,172845,2436913,12.879721,121.774017,-2264068
1995,Romania,122811,964121,45.943161,24.96676,-841310
1995,Peru,55861,465887,-9.189967,-75.015152,-410026
1995,Paraguay,181196,333322,-23.442503,-58.443832,-152126
1995,Papua New Guinea,31809,3965,-6.314993,143.95555,27844
1995,Niue,414,5534,-19.054445,-169.867233,-5120
1995,Rwanda,210742,326408,-1.940278,29.873888,-115666
1995,RÃ©union,64982,2624,-21.115141,55.536384,62358
1995,Palau,4568,5328,7.51498,134.58252,-760
1995,Pakistan,3665602,3317020,30.375321,69.345116,348582
1995,Saint Helena,355,2339,-24.143474,-10.030696,-1984
1995,Oman,521084,4907,21.512583,55.923255,516177
1995,Norway,223951,149905,60.472024,8.468946,74046
1995,Saint Kitts and Nevis,2014,18237,17.357822,-62.782998,-16223
1995,Northern Mariana Islands,31106,4644,17.33083,145.38469,26462
1995,Panama,70440,131972,8.537981,-80.782127,-61532
1995,Seychelles,4514,18921,-4.679574,55.491977,-14407
1995,Mexico,456661,6936551,23.634501,-102.552784,-6479890
1995,Sierra Leone,104349,457089,8.460555,-11.779889,-352740
1995,Liberia,189728,548712,6.428055,-9.429499,-358984
1995,Sudan,1019443,730165,12.862807,30.217636,289278
1995,Lebanon,604819,518697,33.854721,35.862285,86122
1995,Suriname,13070,191245,3.919305,-56.027783,-178175
1995,Latvia,538093,128189,56.879635,24.603189,409904
1995,Swaziland,23015,30277,-26.522503,31.465866,-7262
1995,Kuwait,893634,80289,29.31166,47.481766,813345
1995,Sweden,854643,226338,60.128161,18.643501,628305
1995,Libya,508041,76711,26.3351,17.228331,431330
1995,Kiribati,1746,5454,-3.370417,-168.734039,-3708
1995,Switzerland,1312818,334949,46.818188,8.227512,977869
1995,Kazakhstan,3245250,774349,48.019573,66.923684,2470901
1995,Jordan,1534882,283431,30.585164,36.238414,1251451
1995,Tajikistan,347871,115210,38.861034,71.276093,232661
1995,Japan,1358965,637499,36.204824,138.252924,721466
1995,Jamaica,20208,718424,18.109581,-77.297508,-698216
1995,Thailand,809682,381450,15.870032,100.992541,428232
1995,Italy,1774953,3205235,41.87194,12.56738,-1430282
1995,Kenya,511762,234939,-0.023559,37.906193,276823
1995,Sri Lanka,39215,921687,7.873054,80.771797,-882472
1995,Liechtenstein,13250,3021,47.166,9.555373,10229
1995,Lithuania,259880,256418,55.169438,23.881275,3462
1995,Mayotte,25006,3894,-12.8275,45.166244,21112
1995,Mauritius,6936,110991,-20.348404,57.552152,-104055
1995,Singapore,793855,158106,1.352083,103.819836,635749
1995,Mauritania,88054,150247,21.00789,-10.940835,-62193
1995,Martinique,44999,12469,14.641528,-61.024174,32530
1995,Slovakia,69064,85509,48.669026,19.699024,-16445
1995,Marshall Islands,1305,4429,7.131474,171.184478,-3124
1995,Slovenia,170758,108264,46.151241,14.995463,62494
1995,Malta,17594,109215,35.937496,14.375416,-91621
1995,Mali,157515,779447,17.570692,-3.996166,-621932
1995,Solomon Islands,3888,2578,-9.64571,160.156194,1310
1995,Maldives,17826,1563,3.202778,73.22068,16263
1995,Malaysia,843822,808420,4.210484,101.975766,35402
1995,Somalia,18044,894763,5.152149,46.199616,-876719
1995,Malawi,189007,131894,-13.254308,34.301525,57113
1995,Madagascar,15499,66390,-18.766947,46.869107,-50891
1995,South Africa,953701,401318,-30.559482,22.937506,552383
1995,Luxembourg,125818,29752,49.815273,6.129583,96066
1995,Spain,1012490,1275783,40.463667,-3.74922,-263293
1995,Israel,1554408,189619,31.046051,34.851612,1364789
1995,Kyrgyzstan,498613,94357,41.20438,74.766098,404256
1995,Lesotho,4024,137717,-29.609988,28.233608,-133693
1995,Botswana,35261,23000,-22.328474,24.684866,12261
1995,Cayman Islands,14243,803,19.513469,-80.566956,13440
1995,Aruba,19002,6115,12.52111,-69.968338,12887
1995,Croatia,563714,702810,45.1,15.2,-139096
1995,Benin,88638,267297,9.30769,2.315834,-178659
1995,Angola,33126,369504,-11.202692,17.873887,-336378
1995,Bulgaria,30380,639998,42.733883,25.48583,-609618
1995,Antigua and Barbuda,16990,22391,17.060816,-61.796428,-5401
1995,Central African Republic,75910,37110,6.611111,20.939444,38800
1995,Bangladesh,800479,5416653,23.684994,90.356331,-4616174
1995,Australia,4125550,335035,-25.274398,133.775136,3790515
1995,Anguilla,2450,810,18.220554,-63.068615,1640
1995,British Virgin Islands,8840,675,18.420695,-64.639968,8165
1995,Andorra,39688,4186,42.546245,1.601554,35502
1995,Comoros,12435,50810,-11.875001,43.872219,-38375
1995,Colombia,106189,624857,4.570868,-74.297333,-518668
1995,Austria,894893,482767,47.516231,14.550072,412126
1995,CÃ´te d'Ivoire,2038795,452455,7.539989,-5.54708,1586340
1995,Chad,83902,263082,15.454166,18.732207,-179180
1995,Brazil,713984,731248,-14.235004,-51.92528,-17264
1995,Bahrain,201392,17793,25.930414,50.637772,183599
1995,Cuba,22432,920188,21.521757,-77.781167,-897756
1995,Bhutan,25828,117872,27.514162,90.433601,-92044
1995,Azerbaijan,340965,804025,40.143105,47.576927,-463060
1995,China,344062,2791728,35.86166,104.195397,-2447666
1995,Chile,142417,471484,-35.675147,-71.542969,-329067
1995,Algeria,250204,963763,28.033886,1.659626,-713559
1995,Cyprus,61451,162766,35.126413,33.429859,-101315
1995,Bosnia and Herzegovina,68250,1366791,43.915886,17.679076,-1298541
1995,Bermuda,15980,42601,32.321384,-64.75737,-26621
1995,Afghanistan,55794,1580390,33.93911,67.709953,-1524596
1995,Denmark,303108,203671,56.26392,9.501785,99437
1995,Bahamas,30680,29594,25.03428,-77.39628,1086
1995,Burkina Faso,406520,1213092,12.238333,-1.561593,-806572
1995,Costa Rica,203856,83919,9.748917,-83.753428,119937
1995,Belgium,869676,374081,50.503887,4.469936,495595
1995,Armenia,654786,385111,40.069099,45.038189,269675
1995,Canada,4858489,1050253,56.130366,-106.346771,3808236
1995,Cameroon,197678,131530,7.369722,12.354722,66148
1995,Albania,63452,441271,41.153332,20.168331,-377819
1995,Cook Islands,2607,17012,-21.236736,-159.777671,-14405
1995,Argentina,1512538,446164,-38.416097,-63.616672,1066374
1995,Burundi,214117,104641,-3.373056,29.918886,109476
1995,Cambodia,86480,381421,12.565679,104.990963,-294941
1995,Djibouti,93804,6935,11.825138,42.590275,86869
1995,Barbados,20140,89152,13.193887,-59.543198,-69012
1995,Dominica,2704,40099,15.414999,-61.370976,-37395
1995,American Samoa,22301,1626,-14.270972,-170.132217,20675
1995,Belarus,1186020,844363,53.709807,27.953389,341657
1995,Belize,32317,41002,17.189877,-88.49765,-8685
2000,Indonesia,262999,2193632,-0.789275,113.921327,-1930633
2000,Iceland,15892,25932,64.963051,-19.020835,-10040
2000,Bosnia and Herzegovina,81959,1459806,43.915886,17.679076,-1377847
2000,Cook Islands,2703,19501,-21.236736,-159.777671,-16798
2000,Belgium,837472,397931,50.503887,4.469936,439541
2000,Niger,112419,193026,17.607789,8.081666,-80607
2000,Nicaragua,29063,500060,12.865416,-85.207229,-470997
2000,Peru,65323,651856,-9.189967,-75.015152,-586533
2000,New Caledonia,46612,3822,-20.904305,165.618042,42790
2000,Bhutan,29673,120061,27.514162,90.433601,-90388
2000,China,389735,3483604,35.86166,104.195397,-3093869
2000,India,6286286,7909342,20.593684,78.96288,-1623056
2000,Guam,71382,4419,13.444304,144.793731,66963
2000,New Zealand,645015,486207,-40.900557,174.885971,158808
2000,Netherlands,1552220,747580,52.132633,5.291266,804640
2000,Turkmenistan,215691,49094,38.969719,59.556278,166597
2000,Palau,5714,6472,7.51498,134.58252,-758
2000,Vanuatu,1361,6255,-15.376706,166.959158,-4894
2000,Guinea-Bissau,18937,76131,11.803749,-15.180413,-57194
2000,Comoros,12310,69992,-11.875001,43.872219,-57682
2000,Belize,35321,47220,17.189877,-88.49765,-11899
2000,Pakistan,4178579,3373757,30.375321,69.345116,804822
2000,Guyana,7580,355435,4.860416,-58.93018,-347855
2000,Angola,38485,509164,-11.202692,17.873887,-470679
2000,Oman,596366,6870,21.512583,55.923255,589496
2000,Benin,113401,311550,9.30769,2.315834,-198149
2000,Haiti,23992,798581,18.971187,-72.285215,-774589
2000,Iraq,188245,620590,33.223191,43.679291,-432345
2000,Panama,82912,136233,8.537981,-80.782127,-53321
2000,Norway,278008,162758,60.472024,8.468946,115250
2000,Turkey,1175736,2785268,38.963745,35.243322,-1609532
2000,Tunisia,29634,478946,33.886917,9.537499,-449312
2000,Colombia,108894,813521,4.570868,-74.297333,-704627
2000,Honduras,28320,341752,15.199999,-86.241905,-313432
2000,Northern Mariana Islands,38613,4889,17.33083,145.38469,33724
2000,Uzbekistan,1323853,680138,41.377491,64.585262,643715
2000,Papua New Guinea,23805,4458,-6.314993,143.95555,19347
2000,Paraguay,172346,371189,-23.442503,-58.443832,-198843
2000,Niue,422,5683,-19.054445,-169.867233,-5261
2000,Guatemala,48056,577925,15.783471,-90.230759,-529869
2000,Bermuda,16930,14083,32.321384,-64.75737,2847
2000,Nigeria,437977,598203,9.081999,8.675277,-160226
2000,Hungary,290701,397230,47.162494,19.503304,-106529
2000,Tajikistan,298933,118280,38.861034,71.276093,180653
2000,Uruguay,81477,229838,-32.522779,-55.765835,-148361
2000,Martinique,52961,13968,14.641528,-61.024174,38993
2000,Marshall Islands,1684,7326,7.131474,171.184478,-5642
2000,Cayman Islands,19172,1259,19.513469,-80.566956,17913
2000,Kiribati,1804,5170,-3.370417,-168.734039,-3366
2000,Uganda,631630,516280,1.373333,32.290275,115350
2000,Malta,21358,104236,35.937496,14.375416,-82878
2000,United Kingdom,4692050,3782593,55.378051,-3.435973,909457
2000,Kuwait,1086284,97100,29.31166,47.481766,989184
2000,Burkina Faso,485979,1233579,12.238333,-1.561593,-747600
2000,Mali,138028,705655,17.570692,-3.996166,-567627
2000,Kyrgyzstan,380737,105078,41.20438,74.766098,275659
2000,Maldives,26021,1077,3.202778,73.22068,24944
2000,Malaysia,1166948,1144579,4.210484,101.975766,22369
2000,Burundi,111921,92882,-3.373056,29.918886,19039
2000,Canada,5504699,1123819,56.130366,-106.346771,4380880
2000,Latvia,430178,136590,56.879635,24.603189,293588
2000,Malawi,181962,177651,-13.254308,34.301525,4311
2000,Ukraine,5137559,1925823,48.379433,31.16558,3211736
2000,Lebanon,689524,547232,33.854721,35.862285,142292
2000,Madagascar,17227,76162,-18.766947,46.869107,-58935
2000,Luxembourg,139438,32146,49.815273,6.129583,107292
2000,Lesotho,3699,120380,-29.609988,28.233608,-116681
2000,Cambodia,140279,441077,12.565679,104.990963,-300798
2000,Lithuania,203547,262770,55.169438,23.881275,-59223
2000,Liechtenstein,15389,2655,47.166,9.555373,12734
2000,Liberia,135072,263077,6.428055,-9.429499,-128005
2000,American Samoa,24115,2157,-14.270972,-170.132217,21958
2000,United Arab Emirates,2377888,100724,23.424076,53.847818,2277164
2000,Cameroon,182879,155312,7.369722,12.354722,27567
2000,Kenya,627427,277540,-0.023559,37.906193,349887
2000,Bulgaria,41598,678354,42.733883,25.48583,-636756
2000,Mauritania,55481,104022,21.00789,-10.940835,-48541
2000,Mauritius,14512,115609,-20.348404,57.552152,-101097
2000,Dominica,3225,43340,15.414999,-61.370976,-40115
2000,Chile,177332,487592,-35.675147,-71.542969,-310260
2000,Ireland,350552,818765,53.41291,-8.24389,-468213
2000,Nauru,2206,2637,-0.522778,166.931503,-431
2000,Algeria,241786,1023754,28.033886,1.659626,-781968
2000,Isle of Man,37337,7367,54.236107,-4.548056,29970
2000,Namibia,131616,48111,-22.95764,18.49041,83505
2000,Philippines,233520,2978919,12.879721,121.774017,-2745399
2000,Botswana,48400,26087,-22.328474,24.684866,22313
2000,Turks and Caicos Islands,7746,759,21.694025,-71.797928,6987
2000,Israel,1532124,205398,31.046051,34.851612,1326726
2000,Mozambique,113222,589604,-18.665695,35.529562,-476382
2000,Morocco,42500,1946073,31.791702,-7.09262,-1903573
2000,Chad,98689,200490,15.454166,18.732207,-101801
2000,Nepal,680689,955386,28.394857,84.124008,-274697
2000,Italy,2121690,3061580,41.87194,12.56738,-939890
2000,Brazil,657613,946949,-14.235004,-51.92528,-289336
2000,Jamaica,22292,856741,18.109581,-77.297508,-834449
2000,Mongolia,7368,5183,46.862496,103.846656,2185
2000,Andorra,41238,5605,42.546245,1.601554,35633
2000,United States of America,33157941,1925058,37.09024,-95.712891,31232883
2000,Monaco,11614,4792,43.750298,7.412841,6822
2000,Japan,1648891,683791,36.204824,138.252924,965100
2000,Tuvalu,164,3127,-7.109535,177.64933,-2963
2000,Mexico,536112,9549601,23.634501,-102.552784,-9013489
2000,Central African Republic,87922,38953,6.611111,20.939444,48969
2000,Jordan,1925431,314338,30.585164,36.238414,1611093
2000,British Virgin Islands,10155,955,18.420695,-64.639968,9200
2000,Mayotte,44952,6163,-12.8275,45.166244,38789
2000,Kazakhstan,2871300,971639,48.019573,66.923684,1899661
2000,Montserrat,997,15323,16.742498,-62.187366,-14326
2000,Poland,785539,2021407,51.919438,19.145136,-1235868
2000,Guinea,550515,350060,9.945587,-9.696645,200455
2000,Libya,567436,78299,26.3351,17.228331,489137
2000,Denmark,371026,213254,56.26392,9.501785,157772
2000,South Africa,968186,510914,-30.559482,22.937506,457272
2000,San Marino,3896,3451,43.94236,12.457777,445
2000,Afghanistan,60918,2441534,33.93911,67.709953,-2380616
2000,Bahamas,36041,34298,25.03428,-77.39628,1743
2000,Gabon,190440,15860,-0.803689,11.609444,174580
2000,Samoa,5682,94579,-13.759029,-172.104629,-88897
2000,Aruba,26897,6965,12.52111,-69.968338,19932
2000,Equatorial Guinea,3650,54227,1.650801,10.267895,-50577
2000,Spain,1646788,1218114,40.463667,-3.74922,428674
2000,French Polynesia,26321,4307,-17.679742,-149.406843,22014
2000,Tokelau,238,2081,-8.967363,-171.855881,-1843
2000,Sri Lanka,38504,974916,7.873054,80.771797,-936412
2000,Cuba,15263,1034617,21.521757,-77.781167,-1019354
2000,Gambia,177198,39702,13.443182,-15.310139,137496
2000,Saint Vincent and the Grenadines,4036,52918,12.984305,-61.287228,-48882
2000,Saint Pierre and Miquelon,1276,486,46.941936,-56.27111,790
2000,Georgia,73194,340530,42.315407,43.356892,-267336
2000,El Salvador,31586,948069,13.794185,-88.89653,-916483
2000,Bahrain,232683,39727,25.930414,50.637772,192956
2000,Zimbabwe,361939,309783,-19.015438,29.154857,52156
2000,Saint Lucia,6415,36134,13.909444,-60.978893,-29719
2000,Yemen,112692,527293,15.552727,48.516388,-414601
2000,Saudi Arabia,5086745,131828,23.885942,45.079162,4954917
2000,Eritrea,11295,510406,15.179384,39.782334,-499111
2000,Senegal,197885,380905,14.497401,-14.452362,-183020
2000,Ethiopia,549918,443561,9.145,40.489673,106357
2000,Slovakia,115885,110258,48.669026,19.699024,5627
2000,CÃ´te d'Ivoire,1946601,540888,7.539989,-5.54708,1405713
2000,Fiji,11120,132438,-16.578193,179.414413,-121318
2000,Australia,4337890,373788,-25.274398,133.775136,3964102
2000,Singapore,1218865,175705,1.352083,103.819836,1043160
2000,Zambia,315441,146411,-13.133897,27.849332,169030
2000,Austria,996547,466756,47.516231,14.550072,529791
2000,Finland,134418,313835,61.92411,25.748151,-179417
2000,Solomon Islands,3711,2759,-9.64571,160.156194,952
2000,Sierra Leone,97244,508493,8.460555,-11.779889,-411249
2000,Timor-Leste,9327,148321,-8.874217,125.727539,-138994
2000,Seychelles,6095,8984,-4.679574,55.491977,-2889
2000,Estonia,248999,74782,58.595272,25.013607,174217
2000,Togo,124475,262354,8.619543,0.824782,-137879
2000,France,6278718,1509226,46.227638,2.213749,4769492
2000,Somalia,555,1000233,5.152149,46.199616,-999678
2000,Guadeloupe,78184,7747,16.995971,-62.067641,70437
2000,Serbia,856060,1114335,44.016521,21.005859,-258275
2000,Azerbaijan,325050,784794,40.143105,47.576927,-459744
2000,Antigua and Barbuda,22746,27969,17.060816,-61.796428,-5223
2000,Cyprus,79394,153075,35.126413,33.429859,-73681
2000,French Guiana,72668,3605,3.933889,-53.125782,69063
2000,Sudan,767247,842562,12.862807,30.217636,-75315
2000,Saint Kitts and Nevis,2784,23821,17.357822,-62.782998,-21037
2000,Slovenia,167297,118329,46.151241,14.995463,48968
2000,Gibraltar,6791,8434,36.137741,-5.345374,-1643
2000,Armenia,620649,396986,40.069099,45.038189,223663
2000,Suriname,16143,210942,3.919305,-56.027783,-194799
2000,Costa Rica,300336,104440,9.748917,-83.753428,195896
2000,Trinidad and Tobago,37801,302830,10.691803,-61.222503,-265029
2000,Argentina,1459713,517358,-38.416097,-63.616672,942355
2000,Albania,68202,753282,41.153332,20.168331,-685080
2000,Rwanda,337752,173750,-1.940278,29.873888,164002
2000,Puerto Rico,344921,1598073,18.220833,-66.590149,-1253152
2000,Western Sahara,3157,165937,24.215527,-12.885834,-162780
2000,Ecuador,121958,415728,-1.831239,-78.183406,-293770
2000,Romania,112260,1125632,45.943161,24.96676,-1013372
2000,Germany,8658910,3186185,51.165691,10.451526,5472725
2000,Greece,1111665,985196,39.074208,21.824312,126469
2000,Barbados,21831,94537,13.193887,-59.543198,-72706
2000,Swaziland,19504,33572,-26.522503,31.465866,-14068
2000,Sweden,916621,257542,60.128161,18.643501,659079
2000,Qatar,349667,5181,25.354826,51.183884,344486
2000,RÃ©union,88866,2320,-21.115141,55.536384,86546
2000,Grenada,4355,63036,12.262776,-61.604171,-58681
2000,Greenland,6629,13172,71.706936,-42.604303,-6543
2000,Tonga,1039,46729,-21.178986,-175.198242,-45690
2000,Croatia,480163,871688,45.1,15.2,-391525
2000,Anguilla,2998,1171,18.220554,-63.068615,1827
2000,Switzerland,1468417,365910,46.818188,8.227512,1102507
2000,Belarus,1123275,751083,53.709807,27.953389,372192
2000,Saint Helena,367,3898,-24.143474,-10.030696,-3531
2000,Egypt,163927,1686818,26.820553,30.802498,-1522891
2000,Portugal,646280,1941068,39.399872,-8.224454,-1294788
2000,Ghana,179184,467905,7.946527,-1.023194,-288721
2000,Djibouti,94491,9036,11.825138,42.590275,85455
2000,Bangladesh,859424,5422293,23.684994,90.356331,-4562869
2000,Dominican Republic,354141,871881,18.735693,-70.162651,-517740
2000,Thailand,1257759,487438,15.870032,100.992541,770321
2005,Lithuania,195223,333816,55.169438,23.881275,-138593
2005,Cambodia,109499,664372,12.565679,104.990963,-554873
2005,Switzerland,1696818,498378,46.818188,8.227512,1198440
2005,Mauritania,56084,98143,21.00789,-10.940835,-42059
2005,Tajikistan,280136,120979,38.861034,71.276093,159157
2005,Mauritius,18483,127376,-20.348404,57.552152,-108893
2005,Libya,625212,98430,26.3351,17.228331,526782
2005,Timor-Leste,9930,94981,-8.874217,125.727539,-85051
2005,Mayotte,62089,6411,-12.8275,45.166244,55678
2005,Sweden,1034109,269470,60.128161,18.643501,764639
2005,British Virgin Islands,11635,979,18.420695,-64.639968,10656
2005,Solomon Islands,2836,3076,-9.64571,160.156194,-240
2005,Tuvalu,142,3168,-7.109535,177.64933,-3026
2005,Liechtenstein,18533,2903,47.166,9.555373,15630
2005,Sudan,504726,1157794,12.862807,30.217636,-653068
2005,Marshall Islands,2148,6967,7.131474,171.184478,-4819
2005,Argentina,1613729,771475,-38.416097,-63.616672,842254
2005,Armenia,439319,394448,40.069099,45.038189,44871
2005,Malaysia,1583398,1318053,4.210484,101.975766,265345
2005,American Samoa,23552,2137,-14.270972,-170.132217,21415
2005,Maldives,42763,1678,3.202778,73.22068,41085
2005,Malawi,173395,217530,-13.254308,34.301525,-44135
2005,Slovenia,193277,119170,46.151241,14.995463,74107
2005,Thailand,2163055,577005,15.870032,100.992541,1586050
2005,Mali,187038,781436,17.570692,-3.996166,-594398
2005,Sri Lanka,37860,1125672,7.873054,80.771797,-1087812
2005,Burundi,156940,119712,-3.373056,29.918886,37228
2005,Spain,4102927,1037633,40.463667,-3.74922,3065294
2005,Suriname,19755,249362,3.919305,-56.027783,-229607
2005,Malta,24291,99947,35.937496,14.375416,-75656
2005,Madagascar,19070,147617,-18.766947,46.869107,-128547
2005,Uganda,649897,517793,1.373333,32.290275,132104
2005,South Africa,1179704,616035,-30.559482,22.937506,563669
2005,Antigua and Barbuda,24408,31456,17.060816,-61.796428,-7048
2005,Ukraine,4694360,2121354,48.379433,31.16558,2573006
2005,Luxembourg,150391,45309,49.815273,6.129583,105082
2005,Bulgaria,59498,896438,42.733883,25.48583,-836940
2005,Martinique,55432,14332,14.641528,-61.024174,41100
2005,Aruba,30144,8164,12.52111,-69.968338,21980
2005,Swaziland,22239,40447,-26.522503,31.465866,-18208
2005,Somalia,1159,1145828,5.152149,46.199616,-1144669
2005,Burkina Faso,557720,1311822,12.238333,-1.561593,-754102
2005,Poland,699220,2858490,51.919438,19.145136,-2159270
2005,Australia,4825070,416394,-25.274398,133.775136,4408676
2005,Tonga,1212,48555,-21.178986,-175.198242,-47343
2005,Oman,638222,8952,21.512583,55.923255,629270
2005,Bangladesh,996782,5750858,23.684994,90.356331,-4754076
2005,RÃ©union,102727,2529,-21.115141,55.536384,100198
2005,Norway,351024,173664,60.472024,8.468946,177360
2005,Benin,145428,483467,9.30769,2.315834,-338039
2005,Rwanda,409872,183799,-1.940278,29.873888,226073
2005,Northern Mariana Islands,36049,5035,17.33083,145.38469,31014
2005,Turkey,1210738,2662393,38.963745,35.243322,-1451655
2005,Niue,445,5263,-19.054445,-169.867233,-4818
2005,Saint Kitts and Nevis,3165,25773,17.357822,-62.782998,-22608
2005,Bahrain,392112,44163,25.930414,50.637772,347949
2005,Saint Lucia,7449,43291,13.909444,-60.978893,-35842
2005,Nigeria,870125,780740,9.081999,8.675277,89385
2005,Saint Helena,420,3364,-24.143474,-10.030696,-2944
2005,Pakistan,3167999,3862290,30.375321,69.345116,-694291
2005,Belize,40138,50982,17.189877,-88.49765,-10844
2005,Palau,5368,6203,7.51498,134.58252,-835
2005,Belarus,1106673,728456,53.709807,27.953389,378217
2005,Philippines,188965,3596701,12.879721,121.774017,-3407736
2005,Trinidad and Tobago,40571,318145,10.691803,-61.222503,-277574
2005,Peru,76449,935854,-9.189967,-75.015152,-859405
2005,Portugal,766605,1683793,39.399872,-8.224454,-917188
2005,Paraguay,164176,541075,-23.442503,-58.443832,-376899
2005,Puerto Rico,337632,1640607,18.220833,-66.590149,-1302975
2005,Barbados,20652,92715,13.193887,-59.543198,-72063
2005,Belgium,854807,436822,50.503887,4.469936,417985
2005,Angola,51477,399060,-11.202692,17.873887,-347583
2005,Papua New Guinea,28640,4397,-6.314993,143.95555,24243
2005,Tunisia,28474,571480,33.886917,9.537499,-543006
2005,Panama,116986,130792,8.537981,-80.782127,-13806
2005,Qatar,624746,7871,25.354826,51.183884,616875
2005,Romania,131038,2095122,45.943161,24.96676,-1964084
2005,Bermuda,17393,14929,32.321384,-64.75737,2464
2005,Mexico,710313,10804072,23.634501,-102.552784,-10093759
2005,Niger,114444,285336,17.607789,8.081666,-170892
2005,Saint Pierre and Miquelon,1127,428,46.941936,-56.27111,699
2005,Togo,184229,364236,8.619543,0.824782,-180007
2005,Mozambique,128846,523033,-18.665695,35.529562,-394187
2005,Botswana,77166,30602,-22.328474,24.684866,46564
2005,Turks and Caicos Islands,8149,1236,21.694025,-71.797928,6913
2005,Morocco,43587,2373820,31.791702,-7.09262,-2330233
2005,Seychelles,8568,9430,-4.679574,55.491977,-862
2005,Namibia,104029,58699,-22.95764,18.49041,45330
2005,Austria,1136270,485639,47.516231,14.550072,650631
2005,Sierra Leone,148640,147311,8.460555,-11.779889,1329
2005,Mongolia,10804,7888,46.862496,103.846656,2916
2005,Brazil,622082,1191482,-14.235004,-51.92528,-569400
2005,Singapore,1526620,215226,1.352083,103.819836,1311394
2005,Monaco,11149,18833,43.750298,7.412841,-7684
2005,Slovakia,129931,162152,48.669026,19.699024,-32221
2005,Montserrat,1028,15031,16.742498,-62.187366,-14003
2005,Senegal,201695,452310,14.497401,-14.452362,-250615
2005,Andorra,48526,5758,42.546245,1.601554,42768
2005,Azerbaijan,299730,638670,40.143105,47.576927,-338940
2005,Tokelau,236,2070,-8.967363,-171.855881,-1834
2005,Saint Vincent and the Grenadines,4116,55008,12.984305,-61.287228,-50892
2005,New Zealand,803572,551754,-40.900557,174.885971,251818
2005,Bhutan,37191,117858,27.514162,90.433601,-80667
2005,Turkmenistan,210315,48728,38.969719,59.556278,161587
2005,Bahamas,44923,34605,25.03428,-77.39628,10318
2005,New Caledonia,51014,4004,-20.904305,165.618042,47010
2005,Netherlands,1731449,790222,52.132633,5.291266,941227
2005,Samoa,5339,99244,-13.759029,-172.104629,-93905
2005,Anguilla,3451,1101,18.220554,-63.068615,2350
2005,Nepal,644651,1106227,28.394857,84.124008,-461576
2005,Bosnia and Herzegovina,46518,1480713,43.915886,17.679076,-1434195
2005,San Marino,4069,2863,43.94236,12.457777,1206
2005,Saudi Arabia,6283624,154351,23.885942,45.079162,6129273
2005,Nauru,2075,3147,-0.522778,166.931503,-1072
2005,Nicaragua,33219,434471,12.865416,-85.207229,-401252
2005,Serbia,844426,909135,44.016521,21.005859,-64709
2005,Dominica,3958,58060,15.414999,-61.370976,-54102
2005,Guinea,188224,370334,9.945587,-9.696645,-182110
2005,French Polynesia,28086,2719,-17.679742,-149.406843,25367
2005,French Guiana,82544,3837,3.933889,-53.125782,78707
2005,Ireland,589046,767207,53.41291,-8.24389,-178161
2005,Cook Islands,2902,19573,-21.236736,-159.777671,-16671
2005,Kenya,695958,314643,-0.023559,37.906193,381315
2005,Cyprus,116207,153292,35.126413,33.429859,-37085
2005,Guam,72168,4062,13.444304,144.793731,68106
2005,Chile,273384,518912,-35.675147,-71.542969,-245528
2005,France,6737600,1676192,46.227638,2.213749,5061408
2005,Cayman Islands,21579,1268,19.513469,-80.566956,20311
2005,Iraq,107373,1009661,33.223191,43.679291,-902288
2005,Kiribati,2104,5193,-3.370417,-168.734039,-3089
2005,Vanuatu,1810,7248,-15.376706,166.959158,-5438
2005,Finland,190386,300504,61.92411,25.748151,-110118
2005,Guatemala,57179,735956,15.783471,-90.230759,-678777
2005,United Kingdom,5886598,4053071,55.378051,-3.435973,1833527
2005,Kuwait,1267759,109397,29.31166,47.481766,1158362
2005,Fiji,10829,157321,-16.578193,179.414413,-146492
2005,CÃ´te d'Ivoire,1949646,694913,7.539989,-5.54708,1254733
2005,Zambia,227993,165821,-13.133897,27.849332,62172
2005,Uruguay,75953,291872,-32.522779,-55.765835,-215919
2005,Isle of Man,39596,8510,54.236107,-4.548056,31086
2005,Albania,57570,894505,41.153332,20.168331,-836935
2005,Yemen,137832,628792,15.552727,48.516388,-490960
2005,Kazakhstan,3102962,1140224,48.019573,66.923684,1962738
2005,Gibraltar,7492,9665,36.137741,-5.345374,-2173
2005,Western Sahara,3734,131009,24.215527,-12.885834,-127275
2005,United States of America,36996835,2210807,37.09024,-95.712891,34786028
2005,Jamaica,21721,903462,18.109581,-77.297508,-881741
2005,Greece,1190707,870783,39.074208,21.824312,319924
2005,Ghana,286975,615724,7.946527,-1.023194,-328749
2005,Croatia,516819,831658,45.1,15.2,-314839
2005,Chad,342974,206543,15.454166,18.732207,136431
2005,Germany,9249168,3420257,51.165691,10.451526,5828911
2005,Costa Rica,197870,117220,9.748917,-83.753428,80650
2005,Japan,1947221,691533,36.204824,138.252924,1255688
2005,Greenland,6533,14631,71.706936,-42.604303,-8098
2005,Georgia,69511,344922,42.315407,43.356892,-275411
2005,Algeria,190843,1587317,28.033886,1.659626,-1396474
2005,Central African Republic,67223,116433,6.611111,20.939444,-49210
2005,Jordan,2320998,378038,30.585164,36.238414,1942960
2005,Israel,1438993,234367,31.046051,34.851612,1204626
2005,Gambia,176630,57456,13.443182,-15.310139,119174
2005,Cuba,15197,1143940,21.521757,-77.781167,-1128743
2005,Grenada,4557,63956,12.262776,-61.604171,-59399
2005,Gabon,208505,39682,-0.803689,11.609444,168823
2005,Guadeloupe,83926,7919,16.995971,-62.067641,76007
2005,Ethiopia,462542,520711,9.145,40.489673,-58169
2005,Afghanistan,67045,1646074,33.93911,67.709953,-1579029
2005,India,5808175,9582256,20.593684,78.96288,-3774081
2005,Lebanon,754130,599607,33.854721,35.862285,154523
2005,El Salvador,35894,1117846,13.794185,-88.89653,-1081952
2005,Zimbabwe,320377,477879,-19.015438,29.154857,-157502
2005,China,548425,4570046,35.86166,104.195397,-4021621
2005,Egypt,262661,1878630,26.820553,30.802498,-1615969
2005,Djibouti,86580,12204,11.825138,42.590275,74376
2005,Haiti,28304,964686,18.971187,-72.285215,-936382
2005,Lesotho,3769,143984,-29.609988,28.233608,-140215
2005,Guyana,9984,383971,4.860416,-58.93018,-373987
2005,Ecuador,152503,955310,-1.831239,-78.183406,-802807
2005,United Arab Emirates,3183170,94153,23.424076,53.847818,3089017
2005,Colombia,106966,1208968,4.570868,-74.297333,-1102002
2005,Iceland,25492,28490,64.963051,-19.020835,-2998
2005,Honduras,27737,448599,15.199999,-86.241905,-420862
2005,Dominican Republic,371237,995036,18.735693,-70.162651,-623799
2005,Cameroon,241660,213583,7.369722,12.354722,28077
2005,Liberia,78219,368408,6.428055,-9.429499,-290189
2005,Hungary,359080,445471,47.162494,19.503304,-86391
2005,Uzbekistan,1246984,710458,41.377491,64.585262,536526
2005,Equatorial Guinea,5325,66892,1.650801,10.267895,-61567
2005,Italy,3954785,2684185,41.87194,12.56738,1270600
2005,Denmark,440383,220945,56.26392,9.501785,219438
2005,Guinea-Bissau,19654,79713,11.803749,-15.180413,-60059
2005,Kyrgyzstan,305941,126040,41.20438,74.766098,179901
2005,Eritrea,12391,289155,15.179384,39.782334,-276764
2005,Estonia,233186,87372,58.595272,25.013607,145814
2005,Comoros,11783,95539,-11.875001,43.872219,-83756
2005,Canada,6071574,1160299,56.130366,-106.346771,4911275
2005,Latvia,376725,175160,56.879635,24.603189,201565
2005,Indonesia,258386,2561058,-0.789275,113.921327,-2302672
2010,Benin,177454,516553,9.30769,2.315834,-339099
2010,Guatemala,66302,923955,15.783471,-90.230759,-857653
2010,Puerto Rico,287931,1734278,18.220833,-66.590149,-1446347
2010,Barbados,19424,94248,13.193887,-59.543198,-74824
2010,Northern Mariana Islands,23130,5033,17.33083,145.38469,18097
2010,Belgium,1036630,490115,50.503887,4.469936,546515
2010,Belize,44956,56518,17.189877,-88.49765,-11562
2010,Tunisia,35123,597541,33.886917,9.537499,-562418
2010,Greece,1321149,793742,39.074208,21.824312,527407
2010,Papua New Guinea,24303,4189,-6.314993,143.95555,20114
2010,Honduras,27153,587164,15.199999,-86.241905,-560011
2010,Albania,46939,1058328,41.153332,20.168331,-1011389
2010,Turkey,1255160,2661540,38.963745,35.243322,-1406380
2010,Costa Rica,391708,135430,9.748917,-83.753428,256278
2010,Romania,145069,3264003,45.943161,24.96676,-3118934
2010,Niue,465,5350,-19.054445,-169.867233,-4885
2010,Tonga,1290,51812,-21.178986,-175.198242,-50522
2010,Comoros,11255,107903,-11.875001,43.872219,-96648
2010,Qatar,1406620,12084,25.354826,51.183884,1394536
2010,Haiti,32604,1112607,18.971187,-72.285215,-1080003
2010,Portugal,759742,1870689,39.399872,-8.224454,-1110947
2010,Greenland,6014,16192,71.706936,-42.604303,-10178
2010,Angola,64461,330444,-11.202692,17.873887,-265983
2010,Pakistan,3938511,4956609,30.375321,69.345116,-1018098
2010,Paraguay,156416,760219,-23.442503,-58.443832,-603803
2010,Oman,783100,11146,21.512583,55.923255,771954
2010,Guyana,12378,428165,4.860416,-58.93018,-415787
2010,Uzbekistan,1140101,752599,41.377491,64.585262,387502
2010,Guinea-Bissau,20410,87423,11.803749,-15.180413,-67013
2010,Peru,82847,1275470,-9.189967,-75.015152,-1192623
2010,Vanuatu,2191,7732,-15.376706,166.959158,-5541
2010,Philippines,153633,4570201,12.879721,121.774017,-4416568
2010,Trinidad and Tobago,40940,346544,10.691803,-61.222503,-305604
2010,Belarus,1090088,711835,53.709807,27.953389,378253
2010,Guadeloupe,89657,7958,16.995971,-62.067641,81699
2010,Panama,156722,138817,8.537981,-80.782127,17905
2010,Colombia,123584,1591897,4.570868,-74.297333,-1468313
2010,Cook Islands,3100,20567,-21.236736,-159.777671,-17467
2010,Poland,634946,3806188,51.919438,19.145136,-3171242
2010,Grenada,4771,62569,12.262776,-61.604171,-57798
2010,Norway,516976,182190,60.472024,8.468946,334786
2010,Gibraltar,8192,11637,36.137741,-5.345374,-3445
2010,Guam,72950,3243,13.444304,144.793731,69707
2010,Palau,5341,4682,7.51498,134.58252,659
2010,Guinea,129250,401089,9.945587,-9.696645,-271839
2010,Saint Pierre and Miquelon,997,388,46.941936,-56.27111,609
2010,Bangladesh,1100737,6724603,23.684994,90.356331,-5623866
2010,Spain,6278020,1013387,40.463667,-3.74922,5264633
2010,Denmark,509740,233092,56.26392,9.501785,276648
2010,Equatorial Guinea,6996,76811,1.650801,10.267895,-69815
2010,South Africa,1914144,737431,-30.559482,22.937506,1176713
2010,Aruba,32790,9912,12.52111,-69.968338,22878
2010,Eritrea,13487,274646,15.179384,39.782334,-261159
2010,Somalia,1919,1573103,5.152149,46.199616,-1571184
2010,Solomon Islands,2148,3379,-9.64571,160.156194,-1231
2010,Estonia,217814,104006,58.595272,25.013607,113808
2010,Zambia,130863,202808,-13.133897,27.849332,-71945
2010,CÃ´te d'Ivoire,2018304,781858,7.539989,-5.54708,1236446
2010,Slovenia,253728,123562,46.151241,14.995463,130166
2010,Ethiopia,510644,614557,9.145,40.489673,-103913
2010,Australia,5821210,469765,-25.274398,133.775136,5351445
2010,Timor-Leste,10158,34967,-8.874217,125.727539,-24809
2010,Thailand,3223380,693720,15.870032,100.992541,2529660
2010,Slovakia,145694,222349,48.669026,19.699024,-76655
2010,El Salvador,40202,1336616,13.794185,-88.89653,-1296414
2010,Armenia,194741,399746,40.069099,45.038189,-205005
2010,Dominica,4664,66226,15.414999,-61.370976,-61562
2010,Tajikistan,277849,123469,38.861034,71.276093,154380
2010,Switzerland,1958346,623369,46.818188,8.227512,1334977
2010,Montenegro,78125,122283,42.708678,19.37439,-44158
2010,Sweden,1249446,298862,60.128161,18.643501,950584
2010,Dominican Republic,385696,1158847,18.735693,-70.162651,-773151
2010,Argentina,1767689,897183,-38.416097,-63.616672,870506
2010,Swaziland,24283,68614,-26.522503,31.465866,-44331
2010,Djibouti,95499,13528,11.825138,42.590275,81971
2010,Antigua and Barbuda,26040,36075,17.060816,-61.796428,-10035
2010,Suriname,23306,257866,3.919305,-56.027783,-234560
2010,Ecuador,276341,1118352,-1.831239,-78.183406,-842011
2010,Zimbabwe,286242,813007,-19.015438,29.154857,-526765
2010,Sudan,554541,1195743,12.862807,30.217636,-641202
2010,Egypt,283475,2584529,26.820553,30.802498,-2301054
2010,Sri Lanka,37190,1413629,7.873054,80.771797,-1376439
2010,Rwanda,417680,180922,-1.940278,29.873888,236758
2010,Singapore,1919435,269205,1.352083,103.819836,1650230
2010,Sierra Leone,96482,135542,8.460555,-11.779889,-39060
2010,Bahamas,53806,35714,25.03428,-77.39628,18092
2010,Saint Vincent and the Grenadines,4202,54649,12.984305,-61.287228,-50447
2010,Gambia,180372,79489,13.443182,-15.310139,100883
2010,Tokelau,395,2158,-8.967363,-171.855881,-1763
2010,Hungary,427420,509189,47.162494,19.503304,-81769
2010,Saint Lucia,7867,46731,13.909444,-60.978893,-38864
2010,Georgia,70189,367111,42.315407,43.356892,-296922
2010,Bahrain,638094,45100,25.930414,50.637772,592994
2010,Saint Kitts and Nevis,3431,27027,17.357822,-62.782998,-23596
2010,Croatia,553434,858450,45.1,15.2,-305016
2010,Germany,9711410,3687822,51.165691,10.451526,6023588
2010,Saint Helena,475,3128,-24.143474,-10.030696,-2653
2010,Ghana,258896,715521,7.946527,-1.023194,-456625
2010,RÃ©union,110834,2789,-21.115141,55.536384,108045
2010,Western Sahara,4312,144266,24.215527,-12.885834,-139954
2010,Gabon,237590,56792,-0.803689,11.609444,180798
2010,Fiji,11627,185072,-16.578193,179.414413,-173445
2010,Cuba,13880,1294448,21.521757,-77.781167,-1280568
2010,French Polynesia,27588,1163,-17.679742,-149.406843,26425
2010,Finland,246266,292071,61.92411,25.748151,-45805
2010,Austria,1275992,509022,47.516231,14.550072,766970
2010,Seychelles,11053,32253,-4.679574,55.491977,-21200
2010,Afghanistan,73174,2610188,33.93911,67.709953,-2537014
2010,Cyprus,186874,162240,35.126413,33.429859,24634
2010,Serbia,825407,828041,44.016521,21.005859,-2634
2010,France,7196481,1927676,46.227638,2.213749,5268805
2010,Togo,235112,381625,8.619543,0.824782,-146513
2010,Senegal,215154,525793,14.497401,-14.452362,-310639
2010,French Guiana,92413,4038,3.933889,-53.125782,88375
2010,Azerbaijan,274411,410895,40.143105,47.576927,-136484
2010,Saudi Arabia,8147064,189779,23.885942,45.079162,7957285
2010,Yemen,250376,877339,15.552727,48.516388,-626963
2010,Anguilla,3756,844,18.220554,-63.068615,2912
2010,San Marino,4192,2217,43.94236,12.457777,1975
2010,Samoa,4671,104774,-13.759029,-172.104629,-100103
2010,Nigeria,887531,979005,9.081999,8.675277,-91474
2010,Libya,683998,126447,26.3351,17.228331,557551
2010,Mauritius,23497,153002,-20.348404,57.552152,-129505
2010,Jamaica,21153,995518,18.109581,-77.297508,-974365
2010,Kyrgyzstan,226524,146095,41.20438,74.766098,80429
2010,Ireland,730542,775666,53.41291,-8.24389,-45124
2010,Nauru,1944,3606,-0.522778,166.931503,-1662
2010,Brazil,586789,1500255,-14.235004,-51.92528,-913466
2010,Bosnia and Herzegovina,37841,1564516,43.915886,17.679076,-1526675
2010,Malawi,170320,268192,-13.254308,34.301525,-97872
2010,Iraq,91594,1438923,33.223191,43.679291,-1347329
2010,Nepal,556029,1349813,28.394857,84.124008,-793784
2010,Latvia,313786,218234,56.879635,24.603189,95552
2010,Chile,369436,546303,-35.675147,-71.542969,-176867
2010,Bulgaria,74877,1114054,42.733883,25.48583,-1039177
2010,Burundi,215702,131284,-3.373056,29.918886,84418
2010,Monaco,10842,26412,43.750298,7.412841,-15570
2010,Uganda,526101,551066,1.373333,32.290275,-24965
2010,Kenya,867762,369223,-0.023559,37.906193,498539
2010,Netherlands,1827558,872268,52.132633,5.291266,955290
2010,Central African Republic,66524,208707,6.611111,20.939444,-142183
2010,Martinique,57901,14628,14.641528,-61.024174,43273
2010,Malaysia,2219148,1541100,4.210484,101.975766,678048
2010,Mongolia,15510,12003,46.862496,103.846656,3507
2010,Andorra,49544,7120,42.546245,1.601554,42424
2010,Marshall Islands,2749,6751,7.131474,171.184478,-4002
2010,Morocco,58819,2764000,31.791702,-7.09262,-2705181
2010,Turks and Caicos Islands,12734,1724,21.694025,-71.797928,11010
2010,Botswana,106209,46803,-22.328474,24.684866,59406
2010,Mali,223932,825695,17.570692,-3.996166,-601763
2010,Malta,32228,98338,35.937496,14.375416,-66110
2010,Israel,1363316,265972,31.046051,34.851612,1097344
2010,Chad,406162,185419,15.454166,18.732207,220743
2010,Kiribati,2407,5425,-3.370417,-168.734039,-3018
2010,Burkina Faso,629595,1387436,12.238333,-1.561593,-757841
2010,Madagascar,21151,157736,-18.766947,46.869107,-136585
2010,Mozambique,144891,559349,-18.665695,35.529562,-414458
2010,Italy,5787898,2555641,41.87194,12.56738,3232257
2010,Maldives,51407,2721,3.202778,73.22068,48686
2010,Canada,6751310,1235355,56.130366,-106.346771,5515955
2010,United States of America,42071829,2555222,37.09024,-95.712891,39516607
2010,Kazakhstan,3334623,1287395,48.019573,66.923684,2047228
2010,Isle of Man,41377,10293,54.236107,-4.548056,31084
2010,Namibia,100198,99144,-22.95764,18.49041,1054
2010,American Samoa,22991,1932,-14.270972,-170.132217,21059
2010,United Kingdom,7560559,4371216,55.378051,-3.435973,3189343
2010,Montserrat,1061,15507,16.742498,-62.187366,-14446
2010,Turkmenistan,195437,49718,38.969719,59.556278,145719
2010,Kuwait,1765407,163526,29.31166,47.481766,1601881
2010,Lesotho,3840,243640,-29.609988,28.233608,-239800
2010,Jordan,2716659,540080,30.585164,36.238414,2176579
2010,Lithuania,160374,413533,55.169438,23.881275,-253159
2010,Iceland,35091,33497,64.963051,-19.020835,1594
2010,Liechtenstein,21704,3427,47.166,9.555373,18277
2010,New Zealand,908399,659033,-40.900557,174.885971,249366
2010,India,5330039,13249607,20.593684,78.96288,-7919568
2010,Nicaragua,35536,608823,12.865416,-85.207229,-573287
2010,Cameroon,280209,269461,7.369722,12.354722,10748
2010,China,707128,5494590,35.86166,104.195397,-4787462
2010,Niger,116285,311228,17.607789,8.081666,-194943
2010,Bermuda,17857,15845,32.321384,-64.75737,2012
2010,Mexico,966873,12400864,23.634501,-102.552784,-11433991
2010,United Arab Emirates,7094180,111494,23.424076,53.847818,6982686
2010,British Virgin Islands,14478,1038,18.420695,-64.639968,13440
2010,Luxembourg,248490,54274,49.815273,6.129583,194216
2010,Algeria,209723,1628704,28.033886,1.659626,-1418981
2010,Cambodia,78719,936778,12.565679,104.990963,-858059
2010,Liberia,92870,264162,6.428055,-9.429499,-171292
2010,Ukraine,4479141,2284104,48.379433,31.16558,2195037
2010,Bhutan,44708,86159,27.514162,90.433601,-41451
2010,Tuvalu,123,3229,-7.109535,177.64933,-3106
2010,Uruguay,70356,329815,-32.522779,-55.765835,-259459
2010,Japan,2064499,721687,36.204824,138.252924,1342812
2010,New Caledonia,55415,4186,-20.904305,165.618042,51229
2010,Cayman Islands,23985,1238,19.513469,-80.566956,22747
2010,Mayotte,71248,6295,-12.8275,45.166244,64953
2010,Indonesia,270353,3314726,-0.789275,113.921327,-3044373
2010,Mauritania,56954,110989,21.00789,-10.940835,-54035
2010,Lebanon,818738,689762,33.854721,35.862285,128976
2015,Cuba,12494,1493765,21.521757,-77.781167,-1481271
2015,British Virgin Islands,16213,1060,18.420695,-64.639968,15153
2015,Finland,313883,286480,61.92411,25.748151,27403
2015,Malta,40425,100190,35.937496,14.375416,-59765
2015,Samoa,4494,114206,-13.759029,-172.104629,-109712
2015,Sierra Leone,90246,149989,8.460555,-11.779889,-59743
2015,Kiribati,2444,6090,-3.370417,-168.734039,-3646
2015,Fiji,11975,208103,-16.578193,179.414413,-196128
2015,Bulgaria,132140,1153059,42.733883,25.48583,-1020919
2015,French Polynesia,26208,1256,-17.679742,-149.406843,24952
2015,Martinique,59987,13354,14.641528,-61.024174,46633
2015,Tuvalu,111,3458,-7.109535,177.64933,-3347
2015,Senegal,221160,529900,14.497401,-14.452362,-308740
2015,French Guiana,103768,4331,3.933889,-53.125782,99437
2015,Kenya,1023927,421971,-0.023559,37.906193,601956
2015,Cayman Islands,23656,1230,19.513469,-80.566956,22426
2015,Togo,255407,436041,8.619543,0.824782,-180634
2015,Serbia,806777,912272,44.016521,21.005859,-105495
2015,Saudi Arabia,10408329,245953,23.885942,45.079162,10162376
2015,Antigua and Barbuda,27688,43830,17.060816,-61.796428,-16142
2015,Anguilla,4022,816,18.220554,-63.068615,3206
2015,Marshall Islands,2924,7551,7.131474,171.184478,-4627
2015,Yemen,337133,1086844,15.552727,48.516388,-749711
2015,Kazakhstan,3546778,1333989,48.019573,66.923684,2212789
2015,Azerbaijan,261751,364841,40.143105,47.576927,-103090
2015,Austria,1492374,526466,47.516231,14.550072,965908
2015,Cyprus,190334,155153,35.126413,33.429859,35181
2015,San Marino,4928,2263,43.94236,12.457777,2665
2015,Mauritania,160996,115416,21.00789,-10.940835,45580
2015,Seychelles,12367,37790,-4.679574,55.491977,-25423
2015,United Kingdom,8370798,4630211,55.378051,-3.435973,3740587
2015,France,7918382,2095935,46.227638,2.213749,5822447
2015,Gambia,186955,84380,13.443182,-15.310139,102575
2015,Singapore,2261026,302445,1.352083,103.819836,1958581
2015,Sri Lanka,37778,1602723,7.873054,80.771797,-1564945
2015,Burundi,262969,164180,-3.373056,29.918886,98789
2015,Lebanon,1971580,759415,33.854721,35.862285,1212165
2015,Egypt,545125,3173288,26.820553,30.802498,-2628163
2015,Luxembourg,260197,57737,49.815273,6.129583,202460
2015,Sudan,602073,1307378,12.862807,30.217636,-705305
2015,Cameroon,504874,314100,7.369722,12.354722,190774
2015,Ecuador,316204,1066884,-1.831239,-78.183406,-750680
2015,Montenegro,81568,125740,42.708678,19.37439,-44172
2015,Ukraine,4494136,2377190,48.379433,31.16558,2116946
2015,Suriname,27487,275389,3.919305,-56.027783,-247902
2015,Lithuania,135684,496672,55.169438,23.881275,-360988
2015,Argentina,2042145,899917,-38.416097,-63.616672,1142228
2015,Djibouti,105630,15515,11.825138,42.590275,90115
2015,Lesotho,3932,308922,-29.609988,28.233608,-304990
2015,Swaziland,24455,86596,-26.522503,31.465866,-62141
2015,Zimbabwe,262349,965801,-19.015438,29.154857,-703452
2015,Dominican Republic,407095,1372623,18.735693,-70.162651,-965528
2015,Liechtenstein,23089,3867,47.166,9.555373,19222
2015,Sweden,1519535,326820,60.128161,18.643501,1192715
2015,Tajikistan,274780,116888,38.861034,71.276093,157892
2015,Dominica,5437,62628,15.414999,-61.370976,-57191
2015,Cambodia,71024,1016728,12.565679,104.990963,-945704
2015,Switzerland,2301309,645892,46.818188,8.227512,1655417
2015,Libya,771146,153718,26.3351,17.228331,617428
2015,Madagascar,23463,171236,-18.766947,46.869107,-147773
2015,El Salvador,41918,1508523,13.794185,-88.89653,-1466605
2015,Armenia,169744,414299,40.069099,45.038189,-244555
2015,United Arab Emirates,7752052,124300,23.424076,53.847818,7627752
2015,Timor-Leste,10369,37751,-8.874217,125.727539,-27382
2015,Australia,6684394,504967,-25.274398,133.775136,6179427
2015,Kuwait,2751639,180465,29.31166,47.481766,2571174
2015,Algeria,231471,1784029,28.033886,1.659626,-1552558
2015,Slovakia,176420,260197,48.669026,19.699024,-83777
2015,Canada,7550030,1275309,56.130366,-106.346771,6274721
2015,Ethiopia,1088041,740034,9.145,40.489673,348007
2015,Uganda,1148923,575441,1.373333,32.290275,573482
2015,Maldives,60058,2782,3.202778,73.22068,57276
2015,Slovenia,237504,133388,46.151241,14.995463,104116
2015,CÃ´te d'Ivoire,2095575,841044,7.539989,-5.54708,1254531
2015,Burkina Faso,658342,1450829,12.238333,-1.561593,-792487
2015,Mali,243182,1023102,17.570692,-3.996166,-779920
2015,Solomon Islands,2005,3798,-9.64571,160.156194,-1793
2015,Zambia,135913,254813,-13.133897,27.849332,-118900
2015,Aruba,34496,12124,12.52111,-69.968338,22372
2015,Eritrea,13715,542809,15.179384,39.782334,-529094
2015,Somalia,18996,1919299,5.152149,46.199616,-1900303
2015,Kyrgyzstan,199981,151200,41.20438,74.766098,48781
2015,Malawi,183314,325025,-13.254308,34.301525,-141711
2015,Equatorial Guinea,8746,91266,1.650801,10.267895,-82520
2015,South Africa,2723244,859673,-30.559482,22.937506,1863571
2015,Latvia,265418,268855,56.879635,24.603189,-3437
2015,Denmark,595876,246253,56.26392,9.501785,349623
2015,Spain,5876033,1199962,40.463667,-3.74922,4676071
2015,Thailand,3485695,778726,15.870032,100.992541,2706969
2015,Malaysia,2448973,1728504,4.210484,101.975766,720469
2015,Estonia,194495,132011,58.595272,25.013607,62484
2015,American Samoa,22944,1992,-14.270972,-170.132217,20952
2015,Gabon,261342,61512,-0.803689,11.609444,199830
2015,Guam,73602,3084,13.444304,144.793731,70518
2015,Haiti,36711,1237490,18.971187,-72.285215,-1200779
2015,Nauru,2625,3765,-0.522778,166.931503,-1140
2015,Peru,89524,1370801,-9.189967,-75.015152,-1281277
2015,Nicaragua,38345,643082,12.865416,-85.207229,-604737
2015,Trinidad and Tobago,42406,356010,10.691803,-61.222503,-313604
2015,Belarus,1082594,702147,53.709807,27.953389,380447
2015,Bosnia and Herzegovina,37621,1599486,43.915886,17.679076,-1561865
2015,Guadeloupe,93022,8260,16.995971,-62.067641,84762
2015,Philippines,155943,5274399,12.879721,121.774017,-5118456
2015,Ireland,749943,760682,53.41291,-8.24389,-10739
2015,Iraq,333517,1327406,33.223191,43.679291,-993889
2015,Namibia,94718,179380,-22.95764,18.49041,-84662
2015,Isle of Man,43066,8625,54.236107,-4.548056,34441
2015,Andorra,39552,7589,42.546245,1.601554,31963
2015,Poland,605185,4207711,51.919438,19.145136,-3602526
2015,Cook Islands,3412,21505,-21.236736,-159.777671,-18093
2015,Vanuatu,2278,8321,-15.376706,166.959158,-6043
2015,Grenada,4823,64366,12.262776,-61.604171,-59543
2015,Chad,503624,210529,15.454166,18.732207,293095
2015,Mozambique,161302,621142,-18.665695,35.529562,-459840
2015,Portugal,861253,2134784,39.399872,-8.224454,-1273531
2015,Northern Mariana Islands,20715,5047,17.33083,145.38469,15668
2015,Angola,532342,382007,-11.202692,17.873887,150335
2015,Mauritius,27033,161663,-20.348404,57.552152,-134630
2015,Oman,1740950,10973,21.512583,55.923255,1729977
2015,Paraguay,152664,838945,-23.442503,-58.443832,-686281
2015,Iceland,39072,38318,64.963051,-19.020835,754
2015,India,5138790,15786966,20.593684,78.96288,-10648176
2015,New Zealand,998715,791653,-40.900557,174.885971,207062
2015,Belize,53029,60288,17.189877,-88.49765,-7259
2015,Uzbekistan,1094008,799088,41.377491,64.585262,294920
2015,Colombia,138319,1689430,4.570868,-74.297333,-1551111
2015,Uruguay,72689,343125,-32.522779,-55.765835,-270436
2015,Pakistan,3625927,5870332,30.375321,69.345116,-2244405
2015,Tunisia,45715,751171,33.886917,9.537499,-705456
2015,Guinea-Bissau,21642,90946,11.803749,-15.180413,-69304
2015,New Caledonia,58254,4486,-20.904305,165.618042,53768
2015,Palau,4800,4574,7.51498,134.58252,226
2015,Nepal,497086,1640523,28.394857,84.124008,-1143437
2015,Bhutan,47189,44038,27.514162,90.433601,3151
2015,Turkmenistan,193860,50670,38.969719,59.556278,143190
2015,Netherlands,1990878,944730,52.132633,5.291266,1046148
2015,Panama,184061,143842,8.537981,-80.782127,40219
2015,Liberia,106376,252943,6.428055,-9.429499,-146567
2015,Belgium,1159846,539764,50.503887,4.469936,620082
2015,Comoros,11204,114948,-11.875001,43.872219,-103744
2015,Indonesia,299297,3792449,-0.789275,113.921327,-3493152
2015,Chile,469436,590617,-35.675147,-71.542969,-121181
2015,Papua New Guinea,29673,4280,-6.314993,143.95555,25393
2015,Guatemala,76258,1080119,15.783471,-90.230759,-1003861
2015,Norway,735664,187793,60.472024,8.468946,547871
2015,Guinea,122129,416746,9.945587,-9.696645,-294617
2015,Greenland,5727,18127,71.706936,-42.604303,-12400
2015,Barbados,20397,94319,13.193887,-59.543198,-73922
2015,Saint Helena,504,3112,-24.143474,-10.030696,-2608
2015,Central African Republic,58076,397208,6.611111,20.939444,-339132
2015,Niue,471,5363,-19.054445,-169.867233,-4892
2015,Bahrain,696373,47733,25.930414,50.637772,648640
2015,Croatia,555944,868377,45.1,15.2,-312433
2015,Brazil,699609,1521750,-14.235004,-51.92528,-822141
2015,Saint Kitts and Nevis,3521,28844,17.357822,-62.782998,-25323
2015,Honduras,38107,699539,15.199999,-86.241905,-661432
2015,Georgia,73673,381105,42.315407,43.356892,-307432
2015,Mexico,1188870,12532712,23.634501,-102.552784,-11343842
2015,Saint Lucia,8296,49443,13.909444,-60.978893,-41147
2015,Tokelau,450,2254,-8.967363,-171.855881,-1804
2015,Japan,2140320,760601,36.204824,138.252924,1379719
2015,Albania,46266,1069589,41.153332,20.168331,-1023323
2015,Afghanistan,364151,2499786,33.93911,67.709953,-2135635
2015,China,813787,6323615,35.86166,104.195397,-5509828
2015,Hungary,455667,568150,47.162494,19.503304,-112483
2015,Saint Pierre and Miquelon,967,432,46.941936,-56.27111,535
2015,Mayotte,72456,6509,-12.8275,45.166244,65947
2015,Turkey,4051301,3066358,38.963745,35.243322,984943
2015,Bahamas,58298,40238,25.03428,-77.39628,18060
2015,Jordan,3109304,642038,30.585164,36.238414,2467266
2015,Nigeria,1076442,1173467,9.081999,8.675277,-97025
2015,Saint Vincent and the Grenadines,4289,58018,12.984305,-61.287228,-53729
2015,Puerto Rico,259070,1867347,18.220833,-66.590149,-1608277
2015,Monaco,10795,28896,43.750298,7.412841,-18101
2015,Guyana,14507,461161,4.860416,-58.93018,-446654
2015,Western Sahara,4967,187256,24.215527,-12.885834,-182289
2015,Israel,1406027,270538,31.046051,34.851612,1135489
2015,Morocco,76656,2850184,31.791702,-7.09262,-2773528
2015,Greece,1242924,858615,39.074208,21.824312,384309
2015,Qatar,1654997,13362,25.354826,51.183884,1641635
2015,Bermuda,18086,15882,32.321384,-64.75737,2204
2015,United States of America,45890296,2804489,37.09024,-95.712891,43085807
2015,Botswana,141110,75783,-22.328474,24.684866,65327
2015,Costa Rica,397749,137488,9.748917,-83.753428,260261
2015,Benin,208093,593228,9.30769,2.315834,-385135
2015,Turks and Caicos Islands,17499,1843,21.694025,-71.797928,15656
2015,Romania,271040,3401679,45.943161,24.96676,-3130639
2015,Tonga,1368,58438,-21.178986,-175.198242,-57070
2015,Germany,10118844,3866272,51.165691,10.451526,6252572
2015,Montserrat,1118,15548,16.742498,-62.187366,-14430
2015,Gibraltar,8741,10446,36.137741,-5.345374,-1705
2015,Rwanda,432675,207845,-1.940278,29.873888,224830
2015,Italy,5805325,2813290,41.87194,12.56738,2992035
2015,Niger,221320,353662,17.607789,8.081666,-132342
2015,Mongolia,17016,14362,46.862496,103.846656,2654
2015,Ghana,306873,826452,7.946527,-1.023194,-519579
2015,RÃ©union,114600,3121,-21.115141,55.536384,111479
2015,Jamaica,20697,1068281,18.109581,-77.297508,-1047584
2015,Bangladesh,1138134,7224952,23.684994,90.356331,-6086818
2017,Turkey,4787371,3384952,38.963745,35.243322,1402419
2017,Zimbabwe,262349,1024059,-19.015438,29.154857,-761710
2017,Tajikistan,272959,111372,38.861034,71.276093,161587
2017,Uruguay,73407,353185,-32.522779,-55.765835,-279778
2017,Ukraine,4539064,2469916,48.379433,31.16558,2069148
2017,Andorra,38565,7653,42.546245,1.601554,30912
2017,Uganda,1623920,581337,1.373333,32.290275,1042583
2017,Uzbekistan,1083064,816681,41.377491,64.585262,266383
2017,United Kingdom,8799334,4823829,55.378051,-3.435973,3975505
2017,Tuvalu,111,3533,-7.109535,177.64933,-3422
2017,Togo,261961,451909,8.619543,0.824782,-189948
2017,Afghanistan,99345,2494308,33.93911,67.709953,-2394963
2017,Western Sahara,5160,193656,24.215527,-12.885834,-188496
2017,Tokelau,464,2324,-8.967363,-171.855881,-1860
2017,American Samoa,22987,1994,-14.270972,-170.132217,20993
2017,Yemen,341053,1187707,15.552727,48.516388,-846654
2017,Turks and Caicos Islands,18893,1912,21.694025,-71.797928,16981
2017,Anguilla,4099,848,18.220554,-63.068615,3251
2017,Tonga,1387,60258,-21.178986,-175.198242,-58871
2017,Timor-Leste,10607,38943,-8.874217,125.727539,-28336
2017,Angola,537657,390233,-11.202692,17.873887,147424
2017,Vanuatu,2315,8544,-15.376706,166.959158,-6229
2017,United States of America,47412413,2900844,37.09024,-95.712891,44511569
2017,Zambia,137257,264344,-13.133897,27.849332,-127087
2017,Trinidad and Tobago,42679,368589,10.691803,-61.222503,-325910
2017,Algeria,240308,1791159,28.033886,1.659626,-1550851
2017,Thailand,3587998,818058,15.870032,100.992541,2769940
2017,Turkmenistan,192547,52392,38.969719,59.556278,140155
2017,United Arab Emirates,8059782,131948,23.424076,53.847818,7927834
2017,Tunisia,46481,765594,33.886917,9.537499,-719113
2017,Albania,46666,1079680,41.153332,20.168331,-1033014
2017,Nauru,2643,3902,-0.522778,166.931503,-1259
2017,Switzerland,2386931,673515,46.818188,8.227512,1713416
2017,Kazakhstan,3635168,1500754,48.019573,66.923684,2134414
2017,Cayman Islands,24256,1281,19.513469,-80.566956,22975
2017,Jordan,3230677,688064,30.585164,36.238414,2542613
2017,Japan,2225908,790525,36.204824,138.252924,1435383
2017,Jamaica,20834,1107481,18.109581,-77.297508,-1086647
2017,Central African Republic,63169,411695,6.611111,20.939444,-348526
2017,Italy,5907461,2969348,41.87194,12.56738,2938113
2017,Israel,1371327,283182,31.046051,34.851612,1088145
2017,Isle of Man,43681,9061,54.236107,-4.548056,34620
2017,Chad,477045,230888,15.454166,18.732207,246157
2017,Ireland,806549,796557,53.41291,-8.24389,9992
2017,Iraq,340175,1385876,33.223191,43.679291,-1045701
2017,Indonesia,306199,4048468,-0.789275,113.921327,-3742269
2017,Chile,488571,611011,-35.675147,-71.542969,-122440
2017,India,5087385,16511925,20.593684,78.96288,-11424540
2017,Iceland,41853,41026,64.963051,-19.020835,827
2017,Hungary,483903,617755,47.162494,19.503304,-133852
2017,Kenya,1018458,458598,-0.023559,37.906193,559860
2017,China,831650,6558816,35.86166,104.195397,-5727166
2017,Kiribati,2526,6186,-3.370417,-168.734039,-3660
2017,Kuwait,2998636,190673,29.31166,47.481766,2807963
2017,Maldives,62619,2835,3.202778,73.22068,59784
2017,Burkina Faso,662304,1472255,12.238333,-1.561593,-809951
2017,Malaysia,2497940,1785375,4.210484,101.975766,712565
2017,Malawi,186695,334559,-13.254308,34.301525,-147864
2017,Madagascar,24756,172012,-18.766947,46.869107,-147256
2017,Burundi,271822,184892,-3.373056,29.918886,86930
2017,Luxembourg,263651,61991,49.815273,6.129583,201660
2017,Lithuania,124373,525051,55.169438,23.881275,-400678
2017,Liechtenstein,23924,4060,47.166,9.555373,19864
2017,Cambodia,73281,1046503,12.565679,104.990963,-973222
2017,Libya,788419,158073,26.3351,17.228331,630346
2017,Liberia,89021,260144,6.428055,-9.429499,-171123
2017,Lesotho,4030,326433,-29.609988,28.233608,-322403
2017,Lebanon,1937602,808216,33.854721,35.862285,1129386
2017,Cameroon,536555,321413,7.369722,12.354722,215142
2017,Latvia,256889,284161,56.879635,24.603189,-27272
2017,Kyrgyzstan,195968,165672,41.20438,74.766098,30296
2017,Canada,7849479,1321091,56.130366,-106.346771,6528388
2017,Mali,255543,1031380,17.570692,-3.996166,-775837
2017,Honduras,38466,721882,15.199999,-86.241905,-683416
2017,Guyana,14636,476514,4.860416,-58.93018,-461878
2017,French Guiana,109245,4363,3.933889,-53.125782,104882
2017,France,7902783,2179157,46.227638,2.213749,5723626
2017,Finland,342437,292068,61.92411,25.748151,50369
2017,Cyprus,187227,162915,35.126413,33.429859,24312
2017,Fiji,12108,215936,-16.578193,179.414413,-203828
2017,Ethiopia,1148464,787652,9.145,40.489673,360812
2017,Estonia,192707,140433,58.595272,25.013607,52274
2017,CÃ´te d'Ivoire,2116521,832381,7.539989,-5.54708,1284140
2017,Eritrea,13790,604564,15.179384,39.782334,-590774
2017,Equatorial Guinea,9617,93866,1.650801,10.267895,-84249
2017,El Salvador,42175,1558751,13.794185,-88.89653,-1516576
2017,Denmark,656789,257781,56.26392,9.501785,399008
2017,Egypt,460666,3385729,26.820553,30.802498,-2925063
2017,Ecuador,325590,1092512,-1.831239,-78.183406,-766922
2017,Dominican Republic,416253,1412342,18.735693,-70.162651,-996089
2017,Djibouti,109142,15820,11.825138,42.590275,93322
2017,Dominica,5474,64290,15.414999,-61.370976,-58816
2017,Cuba,12290,1540473,21.521757,-77.781167,-1528183
2017,Haiti,37635,1273847,18.971187,-72.285215,-1236212
2017,French Polynesia,26746,1299,-17.679742,-149.406843,25447
2017,Gambia,199110,87516,13.443182,-15.310139,111594
2017,Colombia,141443,1738539,4.570868,-74.297333,-1597096
2017,Guinea-Bissau,22675,92600,11.803749,-15.180413,-69925
2017,Guinea,118567,425298,9.945587,-9.696645,-306731
2017,Guatemala,79326,1116742,15.783471,-90.230759,-1037416
2017,Comoros,11204,115775,-11.875001,43.872219,-104571
2017,Guam,75470,3132,13.444304,144.793731,72338
2017,Guadeloupe,93806,8382,16.995971,-62.067641,85424
2017,Grenada,4863,66425,12.262776,-61.604171,-61562
2017,Cook Islands,3458,22249,-21.236736,-159.777671,-18791
2017,Greenland,5730,19919,71.706936,-42.604303,-14189
2017,Greece,1220395,929549,39.074208,21.824312,290846
2017,Gibraltar,8808,10964,36.137741,-5.345374,-2156
2017,Costa Rica,400147,142108,9.748917,-83.753428,258039
2017,Ghana,320812,857056,7.946527,-1.023194,-536244
2017,Germany,12044115,4040764,51.165691,10.451526,8003351
2017,Georgia,75125,385542,42.315407,43.356892,-310417
2017,Croatia,541180,913077,45.1,15.2,-371897
2017,Gabon,272826,63451,-0.803689,11.609444,209375
2017,Antigua and Barbuda,28218,45014,17.060816,-61.796428,-16796
2017,Malta,43344,104930,35.937496,14.375416,-61586
2017,Marshall Islands,2928,7789,7.131474,171.184478,-4861
2017,Saudi Arabia,11774584,255345,23.885942,45.079162,11519239
2017,Azerbaijan,256790,373904,40.143105,47.576927,-117114
2017,San Marino,4990,2295,43.94236,12.457777,2695
2017,Samoa,4434,117511,-13.759029,-172.104629,-113077
2017,Saint Vincent and the Grenadines,4298,59834,12.984305,-61.287228,-55536
2017,Bahamas,60723,41581,25.03428,-77.39628,19142
2017,Saint Pierre and Miquelon,969,445,46.941936,-56.27111,524
2017,Saint Lucia,8360,50900,13.909444,-60.978893,-42540
2017,Saint Kitts and Nevis,3582,29872,17.357822,-62.782998,-26290
2017,Bahrain,714667,49238,25.930414,50.637772,665429
2017,Saint Helena,505,3268,-24.143474,-10.030696,-2763
2017,RÃ©union,116349,3194,-21.115141,55.536384,113155
2017,Rwanda,434205,243968,-1.940278,29.873888,190237
2017,Bangladesh,1161941,7477606,23.684994,90.356331,-6315665
2017,Romania,357521,3567972,45.943161,24.96676,-3210451
2017,Qatar,1688077,13952,25.354826,51.183884,1674125
2017,Puerto Rico,252581,1929045,18.220833,-66.590149,-1676464
2017,Senegal,223133,544825,14.497401,-14.452362,-321692
2017,Barbados,20498,97756,13.193887,-59.543198,-77258
2017,Serbia,801200,936727,44.016521,21.005859,-135527
2017,Seychelles,12486,35873,-4.679574,55.491977,-23387
2017,Sweden,1601107,346690,60.128161,18.643501,1254417
2017,Swaziland,25416,91517,-26.522503,31.465866,-66101
2017,Argentina,2118655,922258,-38.416097,-63.616672,1196397
2017,Suriname,27991,272782,3.919305,-56.027783,-244791
2017,Sudan,710104,1381678,12.862807,30.217636,-671574
2017,Sri Lanka,38053,1703766,7.873054,80.771797,-1665713
2017,Armenia,169311,418643,40.069099,45.038189,-249332
2017,Spain,5931689,1254909,40.463667,-3.74922,4676780
2017,South Africa,2880145,894967,-30.559482,22.937506,1985178
2017,Somalia,21908,1982235,5.152149,46.199616,-1960327
2017,Aruba,34713,12671,12.52111,-69.968338,22042
2017,Solomon Islands,1956,3944,-9.64571,160.156194,-1988
2017,Slovenia,244749,142540,46.151241,14.995463,102209
2017,Slovakia,183350,277748,48.669026,19.699024,-94398
2017,Australia,7008050,525363,-25.274398,133.775136,6482687
2017,Singapore,2331931,313449,1.352083,103.819836,2018482
2017,Sierra Leone,94225,158989,8.460555,-11.779889,-64764
2017,Austria,1660283,579796,47.516231,14.550072,1080487
2017,Bulgaria,151800,1277703,42.733883,25.48583,-1125903
2017,Portugal,876497,2191178,39.399872,-8.224454,-1314681
2017,Philippines,160806,5529202,12.879721,121.774017,-5368396
2017,Netherlands,2050616,997131,52.132633,5.291266,1053485
2017,Nepal,490077,1709996,28.394857,84.124008,-1219919
2017,Bosnia and Herzegovina,36177,1647776,43.915886,17.679076,-1611599
2017,Namibia,92902,189222,-22.95764,18.49041,-96320
2017,Mozambique,166715,635482,-18.665695,35.529562,-468767
2017,Morocco,79476,2896307,31.791702,-7.09262,-2816831
2017,Botswana,146179,79826,-22.328474,24.684866,66353
2017,Montserrat,1126,16141,16.742498,-62.187366,-15015
2017,Mongolia,17568,15210,46.862496,103.846656,2358
2017,Monaco,10903,28935,43.750298,7.412841,-18032
2017,Brazil,718068,1576128,-14.235004,-51.92528,-858060
2017,Mexico,1219725,12950599,23.634501,-102.552784,-11730874
2017,Mayotte,72854,6608,-12.8275,45.166244,66246
2017,Mauritius,27146,166800,-20.348404,57.552152,-139654
2017,British Virgin Islands,16902,1108,18.420695,-64.639968,15794
2017,Mauritania,162800,117232,21.00789,-10.940835,45568
2017,Martinique,59830,13602,14.641528,-61.024174,46228
2017,Bhutan,48289,43967,27.514162,90.433601,4322
2017,Poland,633893,4650183,51.919438,19.145136,-4016290
2017,New Caledonia,59806,4630,-20.904305,165.618042,55176
2017,Nicaragua,39171,655941,12.865416,-85.207229,-616770
2017,Belarus,1078304,712605,53.709807,27.953389,365699
2017,Peru,91737,1414939,-9.189967,-75.015152,-1323202
2017,Paraguay,156614,868664,-23.442503,-58.443832,-712050
2017,Papua New Guinea,31214,4396,-6.314993,143.95555,26818
2017,Belgium,1174608,560792,50.503887,4.469936,613816
2017,Panama,190011,148163,8.537981,-80.782127,41848
2017,Palau,4846,4650,7.51498,134.58252,196
2017,Pakistan,3395315,5926485,30.375321,69.345116,-2531170
2017,Belize,58186,62271,17.189877,-88.49765,-4085
2017,Oman,1989143,11367,21.512583,55.923255,1977776
2017,Norway,787395,195613,60.472024,8.468946,591782
2017,Northern Mariana Islands,20833,5165,17.33083,145.38469,15668
2017,Benin,214775,612438,9.30769,2.315834,-397663
2017,Niue,463,5524,-19.054445,-169.867233,-5061
2017,Nigeria,1108730,1248251,9.081999,8.675277,-139521
2017,Niger,251936,362919,17.607789,8.081666,-110983
2017,Bermuda,17904,16493,32.321384,-64.75737,1411
2017,New Zealand,1025280,829466,-40.900557,174.885971,195814
2017,Montenegro,70135,127768,42.708678,19.37439,-57633
